11111111111
10000010001
11111011101
10001000001
10101111101
10101000001
10101011111
10100010001
10111111101
10000000001
11111111111
