11111111111
10001000001
11101011101
10101000101
10101011101
10001010001
10111110101
10100010101
10101010101
10001000101
11111111111
